6 6 6 6 6 6 6 6 6 6 6 6 3 3 3 3 3 3 3 3 3 3 3 3 3 3 3 3 3 3 3 3 3 3
6 6 14 6 6 6 6 6 6 6 6 6 6 6 6 6 6 6 6 6 6 6 7 10 10 10 10 10 10 10 10 10 10 3
6 6 6 6 6 14 6 14 6 6 6 6 6 7 7 7 7 7 7 7 6 6 7 10 3 3 6 10 6 6 3 3 10 3
6 6 14 14 6 6 6 14 6 6 6 6 6 7 6 6 6 6 14 7 6 6 7 10 3 3 6 10 6 6 3 3 10 3
6 6 6 6 6 6 6 6 6 6 6 6 6 7 6 6 7 7 7 7 6 6 7 10 6 6 6 10 6 6 6 6 10 3
6 6 14 6 14 6 6 6 14 6 6 6 6 7 6 6 7 6 6 6 6 6 7 10 6 6 4 10 4 6 6 6 10 3
6 6 6 6 6 6 6 6 6 6 6 6 6 7 6 6 7 6 6 6 6 6 7 10 10 10 10 10 10 10 10 10 10 3
6 6 6 6 6 6 6 6 14 6 6 6 6 7 6 6 7 6 6 6 6 6 7 10 6 6 4 10 4 6 6 6 10 3
6 6 14 6 6 14 6 6 6 6 6 6 6 7 6 6 7 6 6 6 6 6 7 10 6 6 6 10 6 6 6 6 10 3
6 6 6 6 6 6 6 6 6 6 6 14 6 8 6 6 8 3 7 3 7 8 7 10 6 6 6 10 6 6 6 6 10 3
6 6 6 14 6 6 6 6 14 6 6 6 1 6 6 6 6 6 6 6 6 6 6 10 6 6 6 10 6 6 6 6 10 3
6 6 14 14 6 6 6 14 6 6 6 6 1 6 6 6 6 6 6 6 6 6 6 10 6 6 6 10 6 6 6 6 10 3
6 6 6 6 6 6 6 6 6 6 6 6 6 8 3 3 8 3 7 3 7 8 7 10 6 3 3 10 6 6 3 3 10 3
6 6 14 6 6 14 6 14 6 14 6 6 6 6 6 6 6 6 6 6 6 6 7 10 6 3 3 10 6 6 3 3 10 3
6 6 6 14 6 6 6 6 6 6 6 6 6 6 6 6 6 6 6 6 6 6 7 10 10 10 10 10 10 10 10 10 10 3
6 6 6 14 6 6 6 14 14 6 6 6 6 6 6 6 6 6 6 6 6 6 7 7 7 7 7 8 1 1 8 7 7 3
3 6 6 1 6 6 6 6 6 6 6 6 6 6 6 6 6 6 6 6 6 6 6 6 6 6 6 7 10 10 7 6 6 3
3 6 6 6 6 6 6 6 6 14 6 6 6 6 6 6 6 6 6 6 6 6 6 6 6 6 6 7 10 10 7 6 6 3
3 6 6 6 6 6 6 6 6 6 6 6 6 6 6 6 6 6 6 6 6 6 6 6 6 6 6 7 10 10 7 4 4 3
3 6 6 6 6 6 6 6 6 6 6 6 6 6 6 6 6 6 6 6 6 6 6 6 6 6 6 7 10 10 7 6 6 3
3 6 6 6 6 6 6 6 6 6 6 6 6 6 6 6 6 6 6 6 6 6 6 6 6 6 6 7 10 10 7 6 6 3
3 6 6 1 6 6 6 6 6 6 3 4 3 3 3 3 3 3 3 3 3 3 3 8 7 7 7 4 10 10 4 6 6 3
3 6 6 6 6 6 6 6 6 6 6 6 6 6 6 6 6 6 6 6 6 6 6 6 6 6 6 6 10 10 6 6 6 3
3 6 6 6 6 6 6 6 6 6 6 6 6 6 6 6 6 6 6 6 6 6 6 6 6 6 6 6 10 10 6 6 6 3
3 6 6 6 6 6 6 6 6 6 3 4 3 3 3 6 6 6 3 3 3 3 3 8 7 7 7 4 1 1 4 6 6 3
3 6 6 6 6 6 6 6 6 6 6 6 6 6 3 6 6 6 3 6 6 6 6 6 6 6 6 7 10 10 7 6 6 3
3 6 6 6 6 6 6 6 6 6 6 3 3 3 3 6 6 6 3 3 3 3 6 8 7 8 7 8 10 10 7 6 6 3
3 6 6 6 6 6 6 6 6 6 6 3 6 6 6 6 6 6 6 6 6 3 6 8 6 10 10 10 10 10 8 4 4 3
3 6 6 6 6 6 6 6 6 6 6 3 6 6 6 4 6 4 6 6 6 3 6 7 6 10 10 10 10 10 7 6 6 3
3 6 6 6 6 6 6 6 6 6 6 3 6 6 6 6 6 6 6 6 6 3 6 8 6 10 10 10 10 10 7 6 6 3
3 6 6 6 6 6 6 6 6 6 6 3 6 6 6 4 6 4 6 6 6 3 6 7 6 10 10 10 10 10 7 6 6 3
3 6 6 6 6 6 6 6 6 6 6 3 6 6 6 6 6 6 6 6 6 3 6 8 7 8 7 8 7 8 7 6 6 3
3 6 6 6 6 6 6 6 6 6 6 3 6 4 3 6 6 6 3 4 6 3 6 6 6 6 6 6 6 6 6 6 6 3
3 3 3 3 3 3 3 3 3 3 3 3 3 3 3 3 3 3 3 3 3 3 3 3 3 3 3 3 3 3 3 3 3 3