11 11 11 11 11 11 11 11 11 11 11 11 3 3 3 3 3 3 3 3 3 3 3 3 3 3 3 3 3 3 3 3 3 3
12 0 0 0 0 0 0 0 0 0 0 12 0 0 0 0 0 0 0 0 0 0 7 0 0 0 0 0 0 0 0 0 0 3
11 0 0 0 0 0 0 0 0 0 0 11 0 7 7 7 7 7 11 11 0 0 7 0 3 3 0 0 0 0 3 3 0 3
11 0 0 0 0 0 0 0 0 0 0 11 0 7 0 0 0 0 0 16 0 0 7 0 3 3 0 0 0 0 3 3 0 3
11 0 0 0 0 0 0 0 0 0 0 11 0 7 0 0 7 7 11 11 0 0 7 0 0 0 0 0 0 0 0 0 0 3
12 0 0 0 0 11 11 0 0 0 0 12 0 7 0 0 7 0 0 0 0 0 7 0 0 0 4 0 4 0 0 0 0 3
11 0 0 0 0 11 11 0 0 0 0 11 0 7 0 0 7 0 0 0 0 0 7 0 0 0 0 -2 0 0 0 0 0 3
11 0 0 0 0 0 0 0 0 0 0 12 0 7 0 0 7 0 0 0 0 0 7 0 0 0 4 0 4 0 0 0 0 3
11 0 0 0 0 0 0 0 0 0 0 11 0 7 0 0 7 0 0 0 0 0 7 0 0 0 0 0 0 0 0 0 0 3
11 0 0 0 0 11 11 0 0 0 0 11 11 8 0 0 8 3 7 3 7 8 7 0 0 0 0 0 0 0 0 0 0 3
12 0 0 0 0 11 11 0 0 0 0 0 2 0 0 0 0 0 0 0 0 0 0 0 0 0 0 0 0 0 0 0 0 3
11 0 0 0 0 0 0 0 0 0 0 0 2 0 0 0 0 0 0 0 0 0 0 0 0 0 0 0 0 0 0 0 0 3
11 0 0 0 0 0 0 0 0 0 0 11 11 8 3 3 8 3 7 3 7 8 7 0 0 3 3 0 0 0 3 3 0 3
11 0 0 0 0 0 0 0 0 0 0 11 0 0 0 0 0 0 0 0 0 0 7 0 0 3 3 0 0 0 3 3 0 3
11 0 0 0 0 0 0 0 0 0 0 11 0 0 0 0 0 0 0 0 0 0 7 0 0 0 0 0 0 0 0 0 0 3
11 0 0 0 0 0 0 0 0 0 0 11 0 0 0 0 0 0 0 0 0 0 7 7 7 7 7 8 2 2 8 7 7 3
3 11 11 2 11 11 11 11 11 11 11 11 0 0 0 0 0 0 0 0 0 0 0 0 0 0 0 7 0 0 7 0 0 3
3 0 12 0 12 0 0 0 0 0 0 0 0 0 0 0 0 0 0 0 0 0 0 0 0 0 0 7 0 0 7 0 0 3
3 0 11 0 11 0 0 0 0 0 0 0 0 0 0 0 0 0 0 0 0 0 0 0 0 0 0 7 0 0 7 4 4 3
3 0 11 0 11 0 0 0 0 0 0 0 0 0 0 0 0 0 0 0 0 0 0 0 0 0 0 7 0 0 7 0 0 3
3 0 11 0 11 0 0 0 0 0 0 0 0 0 0 0 0 0 0 0 0 0 0 0 0 0 0 7 0 0 7 0 0 3
3 0 12 2 12 11 11 11 11 11 3 4 3 3 3 3 3 3 3 3 3 3 3 8 7 7 7 4 0 0 4 0 0 3
3 0 11 0 0 0 0 0 0 0 0 0 0 0 0 0 0 0 0 0 0 0 0 0 0 0 0 0 0 0 0 0 0 3
3 0 11 0 0 0 0 0 0 0 0 0 0 0 0 0 0 0 0 0 0 0 0 0 0 0 0 0 0 0 0 0 0 3
3 0 11 11 11 11 11 11 11 11 3 4 3 3 3 0 0 0 3 3 3 3 3 8 7 7 7 4 2 2 4 0 0 3
3 0 0 0 0 0 0 0 0 0 0 0 0 0 3 0 0 0 3 0 0 0 0 0 0 0 0 7 0 0 7 0 0 3
3 0 0 0 0 0 0 0 0 0 0 3 3 3 3 0 0 0 3 3 3 3 0 8 7 8 7 8 0 0 7 0 0 3
3 0 0 0 0 0 0 0 0 0 0 3 0 0 0 0 0 0 0 0 0 3 0 8 0 0 0 0 0 0 8 4 4 3
3 0 0 0 0 0 0 0 0 0 0 3 0 0 0 4 0 4 0 0 0 3 0 7 0 0 0 0 0 0 7 0 0 3
3 0 0 0 0 0 0 0 0 0 0 3 0 0 0 0 0 0 0 0 0 3 0 8 0 0 0 0 0 0 7 0 0 3
3 0 0 0 0 0 0 0 0 0 0 3 0 0 0 4 0 4 0 0 0 3 0 7 0 0 0 0 0 0 7 0 0 3
3 0 0 0 0 0 0 0 0 0 0 3 0 0 0 0 0 0 0 0 0 3 0 8 7 8 7 8 7 8 7 0 0 3
3 0 0 0 0 0 0 0 0 0 0 3 0 4 3 0 0 0 3 4 0 3 0 0 0 0 0 0 0 0 0 0 0 3
3 3 3 3 3 3 3 3 3 3 3 3 3 3 3 3 15 3 3 3 3 3 3 3 3 3 3 3 3 3 3 3 3 3