5 5 5 5 5 5 5 5 5 5 5 5 3 3 3 3 3 3 3 3 3 3 3 3 3 3 3 3 3 3 3 3 3 3
6 5 13 5 5 5 5 5 5 5 5 6 5 5 5 5 5 5 5 5 5 5 7 9 9 9 9 9 9 9 9 9 9 3
5 5 5 5 5 13 5 13 5 5 5 5 5 7 7 7 7 7 7 7 5 5 7 9 3 3 5 9 5 5 3 3 9 3
5 5 13 13 5 5 5 13 5 5 5 5 5 7 5 5 5 5 5 7 5 5 7 9 3 3 5 9 5 5 3 3 9 3
5 5 5 5 5 5 5 5 5 5 5 5 5 7 5 5 7 7 7 7 5 5 7 9 5 5 5 9 5 5 5 5 9 3
6 5 13 5 13 5 5 5 13 5 5 6 5 7 5 5 7 5 5 5 5 5 7 9 5 5 4 9 4 5 5 5 9 3
5 5 5 5 5 5 5 5 5 5 5 5 5 7 5 5 7 5 5 5 5 5 7 9 9 9 9 9 9 9 9 9 9 3
5 5 5 5 5 5 5 5 13 5 5 6 5 7 5 5 7 5 5 5 5 5 7 9 5 5 4 9 4 5 5 5 9 3
5 5 13 5 5 13 5 5 5 5 5 5 5 7 5 5 7 5 5 5 5 5 7 9 5 5 5 9 5 5 5 5 9 3
5 5 5 5 5 5 5 5 5 5 5 13 5 8 5 5 8 3 7 3 7 8 7 9 5 5 5 9 5 5 5 5 9 3
6 5 5 13 5 5 5 5 13 5 5 5 1 5 5 5 5 5 5 5 5 5 5 9 5 5 5 9 5 5 5 5 9 3
5 5 13 13 5 5 5 13 5 5 5 5 1 5 5 5 5 5 5 5 5 5 5 9 5 5 5 9 5 5 5 5 9 3
5 5 5 5 5 5 5 5 5 5 5 5 5 8 3 3 8 3 7 3 7 8 7 9 5 3 3 9 5 5 3 3 9 3
5 5 13 5 5 13 5 13 5 13 5 5 5 5 5 5 5 5 5 5 5 5 7 9 5 3 3 9 5 5 3 3 9 3
5 5 5 13 5 5 5 5 5 5 5 5 5 5 5 5 5 5 5 5 5 5 7 9 9 9 9 9 9 9 9 9 9 3
5 5 5 13 5 5 5 13 13 5 5 5 5 5 5 5 5 5 5 5 5 5 7 7 7 7 7 8 1 1 8 7 7 3
3 5 5 1 5 5 5 5 5 5 5 5 5 5 5 5 5 5 5 5 5 5 5 5 5 5 5 7 9 9 7 5 5 3
3 5 6 5 6 5 5 5 5 13 5 5 5 5 5 5 5 5 5 5 5 5 5 5 5 5 5 7 9 9 7 5 5 3
3 5 5 5 5 5 5 5 5 5 5 5 5 5 5 5 5 5 5 5 5 5 5 5 5 5 5 7 9 9 7 4 4 3
3 5 5 5 5 5 5 5 5 5 5 5 5 5 5 5 5 5 5 5 5 5 5 5 5 5 5 7 9 9 7 5 5 3
3 5 5 5 5 5 5 5 5 5 5 5 5 5 5 5 5 5 5 5 5 5 5 5 5 5 5 7 9 9 7 5 5 3
3 5 6 1 6 5 5 5 5 5 3 4 3 3 3 3 3 3 3 3 3 3 3 8 7 7 7 4 9 9 4 5 5 3
3 5 5 5 5 5 5 5 5 5 5 5 5 5 5 5 5 5 5 5 5 5 5 5 5 5 5 5 9 9 5 5 5 3
3 5 5 5 5 5 5 5 5 5 5 5 5 5 5 5 5 5 5 5 5 5 5 5 5 5 5 5 9 9 5 5 5 3
3 5 5 5 5 5 5 5 5 5 3 4 3 3 3 5 5 5 3 3 3 3 3 8 7 7 7 4 1 1 4 5 5 3
3 5 5 5 5 5 5 5 5 5 5 5 5 5 3 5 5 5 3 5 5 5 5 5 5 5 5 7 9 9 7 5 5 3
3 5 5 5 5 5 5 5 5 5 5 3 3 3 3 5 5 5 3 3 3 3 5 8 7 8 7 8 9 9 7 5 5 3
3 5 5 5 5 5 5 5 5 5 5 3 5 5 5 5 5 5 5 5 5 3 5 8 5 9 9 9 9 9 8 4 4 3
3 5 5 5 5 5 5 5 5 5 5 3 5 6 5 4 5 4 5 6 5 3 5 7 5 9 9 9 9 9 7 5 5 3
3 5 5 5 5 5 5 5 5 5 5 3 5 5 5 5 5 5 5 5 5 3 5 8 5 9 9 9 9 9 7 5 5 3
3 5 5 5 5 5 5 5 5 5 5 3 5 6 5 4 5 4 5 6 5 3 5 7 5 9 9 9 9 9 7 5 5 3
3 5 5 5 5 5 5 5 5 5 5 3 5 5 5 5 5 5 5 5 5 3 5 8 7 8 7 8 7 8 7 5 5 3
3 5 5 5 5 5 5 5 5 5 5 3 5 4 3 5 5 5 3 4 5 3 5 5 5 5 5 5 5 5 5 5 5 3
3 3 3 3 3 3 3 3 3 3 3 3 3 3 3 3 3 3 3 3 3 3 3 3 3 3 3 3 3 3 3 3 3 3